###########################
#+$# ^ #                  #
# ## # # ### ### ### ####@#
#    #    #   #   #   #^###
#### # #  # ^ # ^ # ^ #   #
# ^# ^ #  #   #   #   ### #
# ######                  #
#      ################## #
######                    #
###########################
