#############
# @#^ # ^#^ #
# ###   ### #
#     #     #
##### # #####
#  ^# # #^  #
# ### # ### #
#     #     #
#####   #####
#^  ## ##  ^#
###       ###
### ##+## ###
#^  ##$##  ^#
#############
