     ###      
    ##$##     
    # + #     
##### ! ######
#^    !     ^#
# ###!!!#### #
#^          ^#
###### #######
     #@#      
     ###      