     ###      
    ##$##     
    # + #     
##### ! ######
#^    !     ^#
##### ! ######
#^    !     ^#
#####   ######
     #@#      
     ###      