#######################
#^!   #@#   ! ^ !   !!#
#   !     !   !   !  ^#
# ! ^ !!!   ! ^ !   !!#
### !     ! ^ !   !  ^#
#$+   !!!   !   ! ^ !!#
#######################