#######################
#^!   #@#   ! ^ ! ^ !!#
#   !     !   !   !  ^#
#^! ^ !!!   ! ^ !   !!#
### !     ! ^ ! ^ !  ^#
#$+   !!!   !   ! ^ !!#
#######################