!!!!!!!!!!!!!!!!!
!^#^#^#^#^#^#^#^!
!               !
!#! ! ! ! ! ! !#!
!^    ! + !    ^!
!#!!! !+$+! !!!#!
!^    ! + !    ^!
!#! ! ! ! ! ! !#!
!@              !
!#^#^#^#^#^#^#^#!
!!!!!!!!!!!!!!!!!