#####################
#@#^ #  ^  #      ###
# #    ### # #### +$#
# #  #     #    #####
#    #     #### #   #
######## ###^       #
#^#   #   ######### #
#   #   #           #
#####################
